XXXXXXXXXXXXX
XA    X     X
X          aX
X     X     X
X    dX     X
X     X     X
XX XXXX     X
X     XXXX XX
Xb    X     X
X     X     X
X           X
X     X  c  X
XXXXXXXXXXXXX
